????????????????????????????????????????????????????????????????
????????????????????????????????????????????????????????????????
????????????????????????????????????????????????????????????????
████████████████████████████████████████████████████████████████
█++++++++++++++++++++++++++++++++++++++++++++++++++++++++++++++█
█++++++++++++++++++++++++++++++++++++++++++++++++++++++++++++++█
█++++++++++++++++++++++++++++++++++++++++++++++++++++++++++++++█
█++++++++++++++++++++++++++++++++++++++++++++++++++++++++++++++█
█++++++++++++++++++++++++++++++++++++++++++++++++++++++++++++++█
█++++++++++++++++++++++++++++++++++++++++++++++++++++++++++++++█
█++++++++++++++++++++++++++++++++++++++++++++++++++++++++++++++█
█++++++++++++++++++++++++++++++++++++++++++++++++++++++++++++++█
█++++++++++++++++++++++++++++++++++++++++++++++++++++++++++++++█
█++++++++++++++++++++++++++++++++++++++++++++++++++++++++++++++█
█++++++++++++++++++++++++++++++++++++++++++++++++++++++++++++++█
█++++++++++++++++++++++++++++++++++++++++++++++++++++++++++++++█
█++++++++++++++++++++++++++++++++++++++++++++++++++++++++++++++█
█++++++++++++++++++++++++++++++++++++++++++++++++++++++++++++++█
█++++++++++++++++++++++++++++++++++++++++++++++++++++++++++++++█
█++++++++++++++++++++++++++++++++++++++++++++++++++++++++++++++█
█++++++++++++++++++++++++++++++++++++++++++++++++++++++++++++++█
█++++++++++++++++++++++++++++++++++++++++++++++++++++++++++++++█
█++++++++++++++++++++++++++++++++++++++++++++++++++++++++++++++█
█++++++++++++++++++++++++++++++++++++++++++++++++++++++++++++++█
█++++++++++++++++++++++++++++++++++++++++++++++++++++++++++++++█
█++++++++++++++++++++++++++++++++++++++++++++++++++++++++++++++█
████████████████████████████████████████████████████████████████
=
????????????????????????????????????????????????????????????????
????????????????????????????????????????????????????????????????
????????????????????????????????????????????????????????????????
████████████████████████████████████████████████████████████████
█++++++++++++++++++++++++++++++++++++++++++++++++++++++++++++++█
█++++++++++++++++++++++++++++++++++++++++++++++++++++++++++++++█
█++++++++++++++++++++++++++++++++++++++++++++++++++++++++++++++█
█++++++++++++++++++++++++++++++++++++++++++++++++++++++++++++++█
█+++++++++++++++++++++++++++++++++++++++++++█████████++++++++++█
█+++++++++++++++++++++++++++++++++++++++++++█???????█++++++++++█
█+++++++++++++++++++++++++++++++++++++++++++█???????█++++++++++█
█+++++++++++++++++++++++++++++++++++++++++++█???????█++++++++++█
█+++++++++++++++++++++++++++++++++++++++++++█████████++++++++++█
█++++++++++++++++++++++++++++++++++++++++++++++++++++++++++++++█
█++++++++++++++++++++++++++++++++++++++++++++++++++++++++++++++█
█++++++++++++++++++++++++++++++++++++++++++++++++++++++++++++++█
█++++++++++++++++++++++++++++++++++++++++++++++++++++++++++++++█
█++++++++++++++++++++++++++++++++++++++++++++++++++++++++++++++█
█++++++++++++++++++++++++++++++++++++++++++++++++++++++++++++++█
█++++++++++++++++++++++++++++++++++++++++++++++++++++++++++++++█
█++++++++++++++++++++++++++++++++++++++++++++++++++++++++++++++█
█++++++++++++++++++++++++++++++++++++++++++++++++++++++++++++++█
█++++++++++++++++++++++++++++++++++++++++++++++++++++++++++++++█
█++++++++++++++++++++++++++++++++++++++++++++++++++++++++++++++█
█++++++++++++++++++++++++++++++++++++++++++++++++++++++++++++++█
█++++++++++++++++++++++++++++++++++++++++++++++++++++++++++++++█
████████████████████████████████████████████████████████████████
=